v=protocol_version
tid=web_property_id
aip=anonymize_ip
npa=disabling_advertising_personalization
ds=data_source
qt=queue_time
z=cache_buster
cid=client_id
uid=user_id
sc=session_control
uip=user_ip
ua=user_agent
geoid=user_geographical_location
dr=document_referrer
cn=campaign_name
cs=campaign_source
cm=campaign_medium
ck=campaign_keyword
cc=campaign_content
ci=campaign_id
gclid=google_ads_id
dclid=google_display_ads_id
sr=screen_resolution
vp=viewport_size
de=document_encoding
sd=screen_color_depth
ul=user_language
je=is_java_enabled
fl=flash_version
t=hit_type
ni=is_non-interactive_hit
dl=document_location_url
dh=document_host_name
dp=document_path
dt=document_title
cd=screen_name
cg<number>=content_group_<number>
linkid=link_id
an=application_name
aid=application_id
av=application_version
aiid=application_installer_id
ec=event_category
ea=event_action
el=event_label
ev=event_value
ti=transaction_id
ta=transaction_affiliation
tr=transaction_revenue
ts=transaction_shipping
tt=transaction_tax
in=item_name
ip=item_price
iq=items_quantity
ic=item_code
iv=item_category
pr<number>id=product_<number>_sku
pr<number>nm=product_<number>_name
pr<number>br=product_<number>_brand
pr<number>ca=product_<number>_category
pr<number>va=product_<number>_variant
pr<number>pr=product_<number>_price
pr<number>qt=product_<number>_quantity
pr<number>cc=product_<number>_coupon_code
pr<number>ps=product_<number>_position
pr<number>cd<number2>=product_<number>_custom_dimension_<number2>
pr<number>cm<number2>=product_<number>_custom_metric_<number2>
pa=product_action
tcc=transaction_coupon_code
pal=product_action_list
cos=checkout_step
col=checkout_step_option
il<number>nm=product_impression_list_<number>_name
il<number>pi<number2>id=product_<number2>_impression_list_<number>_sku
il<number>pi<number2>nm=product_<number2>_impression_list_<number>_name
il<number>pi<number2>br=product_<number2>_impression_list_<number>_brand
il<number>pi<number2>ca=product_<number2>_impression_list_<number>_category
il<number>pi<number2>va=product_<number2>_impression_list_<number>_variant
il<number>pi<number2>ps=product_<number2>_impression_list_<number>_position
il<number>pi<number2>pr=product_<number2>_impression_list_<number>_price
il<number>pi<number2>cd<number3>=product_<number2>_impression_list_<number>_custom_dimension_<number3>
il<number>pi<number2>cm<number3>=product_<number2>_impression_list_<number>_custom_metric_<number3>
promo<number>id=promotion_<number>_id
promo<number>nm=promotion_<number>_name
promo<number>cr=promotion_<number>_creative
promo<number>ps=promotion_<number>_position
promoa=promotion_action
cu=currency_code
sn=social_network
sa=social_action
st=social_action_target
utc=user_timing_category
utv=user_timing_variable_name
utt=user_timing_time
utl=user_timing_label
plt=page_load_time
dns=dns_time
pdt=page_download_time
rrt=redirect_response_time
tcp=tcp_connect_time
srt=server_response_time
dit=dom_interactive_time
clt=content_load_time
exd=exception_description
exf=is_exception_fatal
cd<number>=custom_dimension_<number>
cm<number>=custom_metric_<number>